mentoring.yogayield.net	FAKEUPDATES
round.macayafoundation.org	FAKEUPDATES
background.bodyguardchicago.com	FAKEUPDATES
described.moraver.com	FAKEUPDATES
books.friendsofthefolsomlibrary.org	FAKEUPDATES
prepare.dawarel3mda.com	FAKEUPDATES
deploy.vanquicktech.com	FAKEUPDATES
form.haysllc.net	FAKEUPDATES
jjffhdjbjncsutyeiks.000webhostapp.com	Gomorrah stealer
f0837288.xsph.ru	CollectorGoomba
vipcloud-my.xyz	Lumma Stealer
nn2.pw	Pony
oldhorse.info	Azorult
globaldate.top	CryptBot
tone1sb.top	CryptBot
tten10sb.top	CryptBot
tsix6sb.top	CryptBot
dl.whatsong.ir	IRATA
tseven7sb.top	CryptBot
teit8vs.top	CryptBot
teit8sb.top	CryptBot
tthre3sb.top	CryptBot
tone1vs.top	CryptBot
oyndr.com	PrivateLoader
server14.duniadekho.bar	Glupteba
server7.duniadekho.bar	Glupteba
luckytradeone.com	Glupteba
duniadekho.bar	Glupteba
top1.banifabused1.xyz	CloudEyE
sub1.banifabused2.xyz	CloudEyE
randomlybackup.duckdns.org	CloudEyE
agustfreeday-my.xyz	Lumma Stealer
asfgze.fun	FAKEUPDATES
mayocap12ok.duckdns.org	NjRAT
dubay.duckdns.org	NjRAT
20junok.duckdns.org	NjRAT
and-tim.at.ply.gg	Nanocore RAT
hoysechichonea.con-ip.com	Remcos
741qu.bounceme.net	AsyncRAT
5junio2023.webredirect.org	Remcos
5junio2023.webredirect.org.ovh.net	Remcos
kefas.id	APT UNC2452
pakistanarmy.xyz	APT Sidewinder
fyzyxe.top	NetSupportManager RAT
netmansrvdns.com	APT Bitter
politicalclearance.serveftp.com	APT Transparent Tribe
aflercoopert.com	Icedid
akedhorrorr.com	Icedid
aloowpromis.com	Icedid
amirkofeefour.com	Icedid
anscowerbrut.com	Icedid
arliapples.com	Icedid
atoryshapsn.com	Icedid
dolscapche.com	Icedid
eloasammer.com	Icedid
fletchersgroop.com	Icedid
fleurdetarbs.com	Icedid
frutmossert.com	Icedid
hloyagorepa.com	Icedid
jinoparterves.com	Icedid
jizzynaf.com	Icedid
kojgimagi.com	Icedid
natursaker.com	Icedid
necgatinh.com	Icedid
nemchaprues.com	Icedid
nerfgamesarche.com	Icedid
palesreapor.com	Icedid
piomasocks.com	Icedid
seahloperd.com	Icedid
skayfingertawr.com	Icedid
skepartisol.com	Icedid
stathorrientd.com	Icedid
tracautomatitspow.com	Icedid
trofpokertak.com	Icedid
voesallientak.com	Icedid
yellorquli.com	Icedid
mediaconn.xyz	Qakbot
mediagic.tk	Qakbot
bestonefind.com	Qakbot
besthomegoods.in	Qakbot
bestdentistinsurat.com	Qakbot
bleu.rfc.zitoprohealth.com	FAKEUPDATES
deperekanuki1.com	NetSupportManager RAT
deperekanuki2.com	NetSupportManager RAT
timestop.online	Mirai
the.timestop.online	Mirai
deeplakes.org	FAKEUPDATES
limonpart.org	FAKEUPDATES
biggreenlimes.org	FAKEUPDATES
fishofgloster.pw	IcedID Downloader
newwildtuna.top	IcedID Downloader
floriventurescapital.linkpc.net	CryptoCore
floriventuresfinance.linkpc.net	CryptoCore
floriventuresfund.linkpc.net	CryptoCore
obituary2.redirectme.net	CryptoCore
yorst.linkpc.net	CryptoCore
toobussy.com	SmokeLoader
camoverde.pw	SmokeLoader
kababonline.shop	APT Donot
electroniccomerceanddatabasesforstudypurposesonly.online	AsyncRAT
salwanazeeze.ddns.net	Remcos
salwanazeeze.duckdns.org	Remcos
eyc.rfc.zitoprohealth.com	FAKEUPDATES
nbjhllilknbjldk.top	FAKEUPDATES
fad.tosts.top	RedLine Stealer
arloapp.host	IRATA
accorg.site	IRATA
hameda.tech	IRATA
wahdanmarble.com	Qakbot
wahedul.xyz	Qakbot
waheedkhan.ca	Qakbot
wahidi.com.pk	Qakbot
waho.com.mx	Qakbot
wahtalmarfa.com	Qakbot
waileylog.pk	Qakbot
waitthouseinc.org	Qakbot
wakhrasoft.com	Qakbot
walakala.com	Qakbot
organicmeateg.com	Qakbot
organikfarm.eu	Qakbot
organikfarm.ro	Qakbot
organizate.iw.al	Qakbot
organizationlist.com	Qakbot
orgbless.com	Qakbot
orhanconsultancy.com	Qakbot
oribat.ci	Qakbot
oric.superior.edu.pk	Qakbot
kainyawires.com	Qakbot
kairosfm.cl	Qakbot
kairosgroups.org	Qakbot
kairosigreja.com	Qakbot
kairosinternacional.com	Qakbot
kairukipharmaceuticals.org	Qakbot
kaisamconsult.ng	Qakbot
kaisarinttravels.co.in	Qakbot
zettafull2023.3utilities.com	Mekotio
tolatilbu.hopto.org	Remcos
rnnfibiteammony.duckdns.org	Remcos
gvfrvnjiksnvodmvo.con-ip.com	Remcos
www.monarkpapes.com	Remcos
marketisportsstumi.win	Remcos
tempshsavesprt.info	Remcos
clothingappspalreta.net	Remcos
kaliinuxnowwdangerou.org	Remcos
marketisportsstumi.win	Remcos
tempshsavesprt.info	Remcos
clothingappspalreta.net	Remcos
kaliinuxnowwdangerou.org	Remcos
akakilapphasrespsp.com	Remcos
caddimilopidelphsimpl.de	Remcos
ippallsmenremrmc.photography	Remcos
kerlamaabramsurf.com	Remcos
malsfedgortrtza.com	Remcos
mastrrokiakivasai.com	Remcos
mmnedgeggrrva.com	Remcos
nikecostanzo.com	Remcos
servings.info	APT Donot
nbcot.info	APT Sidewinder
baotrang-jewelry.com	Formbook
date-store.info	Formbook
dinohoki85.online	Formbook
marathon.teachmemoney.net	FAKEUPDATES
forbes.firstmillionaires.com	FAKEUPDATES
cosplay.univisuo.com	FAKEUPDATES
brands.shopperstreets.com	FAKEUPDATES
sandwiches.tropipackfood.com	FAKEUPDATES
flowers-my.xyz	Lumma Stealer
deracak.com	QakBot
fikqso.com	QakBot
ilapset.com	QakBot
utokra.com	QakBot
weswtef.com	QakBot
wewesuga.com	QakBot
cmbefalcljjblia.top	FAKEUPDATES
wvw.dasauto.top	RedLine Stealer
yfive5ht.top	CryptBot
24decline.remmaoso.ru	APT Gamaredon
100delivery.remmaoso.ru	APT Gamaredon
39delicious.remmaoso.ru	APT Gamaredon
53delicious.remmaoso.ru	APT Gamaredon
65delightful.remmaoso.ru	APT Gamaredon
71decline.remmaoso.ru	APT Gamaredon
71destruction.remmaoso.ru	APT Gamaredon
77despise.remmaoso.ru	APT Gamaredon
95delicious.remmaoso.ru	APT Gamaredon
96decency.remmaoso.ru	APT Gamaredon
konmm.com	PrivateLoader
kiknu.com	PrivateLoader
amonro.com	PrivateLoader
abukss.com	PrivateLoader
voutew.com	PrivateLoader
munkop.com	PrivateLoader
nosnou.com	PrivateLoader
lomogd.com	PrivateLoader
gowtos.com	PrivateLoader
atraus.com	PrivateLoader
graphicstoppro.com	PrivateLoader
atridis.com	PrivateLoader
amunutus.com	PrivateLoader
arakusus.com	PrivateLoader
oolomos.com	PrivateLoader
overseeby.com	Konni
yone1sr.top	CryptBot
ythre3sr.top	CryptBot
ynein9ht.top	CryptBot
yfive5vt.top	CryptBot
ysix6sr.top	CryptBot
yfive5sr.top	CryptBot
aa.imgjeoogbb.com	Fabookie
app.nnnaajjjgc.com	Fabookie
ysix6vt.top	CryptBot
yseven7sr.top	CryptBot
yone1vt.top	CryptBot
yeit8sr.top	CryptBot
yeit8vt.top	CryptBot
ysix6pt.top	CryptBot
ynein9pt.top	CryptBot
yone1pt.top	CryptBot
yfive5pt.top	CryptBot
yseven7pt.top	CryptBot
yeit8pt.top	CryptBot
ythre3pt.top	CryptBot
skofilldrom.com	IcedID Downloader
c3c73sqbsxtwssv.top	FAKEUPDATES
slurpslimes.org	FAKEUPDATES
webcarewellclinic.com	Bitter RAT
www.webcarewellclinic.com	Bitter RAT
tos.kentla.top	RedLine Stealer
anguisbi.ru	APT Gamaredon
cresozoq.ru	APT Gamaredon
humorumbi.ru	APT Gamaredon
imbriumbi.ru	APT Gamaredon
macda.ru	APT Gamaredon
mojavebo.ru	APT Gamaredon
nicsan.ru	APT Gamaredon
patrios.ru	APT Gamaredon
saharabo.ru	APT Gamaredon
wadibo.ru	APT Gamaredon
wahibabo.ru	APT Gamaredon
kanzproperties.com	Qakbot
moonexpertss.com	Qakbot
moonlightngwire.com	Qakbot
moonshinestorebd.com	Qakbot
moonsteel.rw	Qakbot
moontaxiandlimousines.com	Qakbot
moovride.com	Qakbot
sistemasavigenser.com	Qakbot
sistemasdelcaribe.com	Qakbot
sistemasocr.com	Qakbot
sistemaspe.com.br	Qakbot
sistemasweb.info	Qakbot



